Start: 80,20
Goal: 79,90
0,0 0,149 149,149 149,148 1,148 1,0
0,0 149,0 149,149 148,149 148,1 0,1
35,50 115,50 115,70 35,70
35,50 55,50 55,130 35,130
105,50 125,50 125,130 105,130