Start: 10,10
Goal: 125,25
0,0 0,149 149,149 149,148 1,148 1,0
0,0 149,0 149,149 148,149 148,1 0,1
20,0 20,110 30,110 30,0
20,120 20,149 30,149 30,120
60,149 60,40 70,40 70,149
60,0 60,30 70,30 70,0
100,0 100,110 110,110 110,0
100,120 100,149 110,149 110,120
120,130 120,140 149,140 149,130
140,110 149,110 149,100 140,100
130,110 130,100 110,100 110,110
110,80 120,80 120,70 110,70 
130,80 149,80 149,70 130,70
149,50 149,40 140,40 140,50
130,50 130,40 110,40 110,50 
110,0 110,10 140,10 140,40 149,40 149,0