Start: 10,140
Goal: 140,40
0,0 0,149 149,149 149,148 1,148 1,0
0,0 149,0 149,149 148,149 148,1 0,1
10,90 20,100 10,110 20,120 20,130 30,140 40,130 30,120 40,110 25,105 40,100
20,80 30,90 50,90 60,80 60,60 50,50 30,50 20,60 40,60 45,65 45,75 40,80
10,40 20,50 40,30 30,20
40,20 50,40 60,30
50,110 60,130 60,100
65,100 80,110 70,130 90,140 90,130 85,120 100,110 
70,90 80,100 90,90 80,80
70,40 70,70 90,70
70,20 80,40 100,50 110,40 100,20 80,10
100,130 110,140 110,130 135,140 110,110 110,120
100,90 120,70 115,60 120,50 95,60 105,70
110,10 120,30 130,40 140,20
110,100 130,120 140,110 120,90
125,80 130,90 130,80 140,60 140,50 130,60