Start: 15,15
Goal: 135,15
0,0 0,149 149,149 149,148 1,148 1,0
0,0 149,0 149,149 148,149 148,1 0,1
0,100 0,149 149,149 149,100
0,0 0,100 10,100 10,0
10,0 10,10 140,10 140,0
20,10 20,90 130,90 130,10
140,0 140,100 149,100 149,0